##########
#S#      #
# # #### #
# # #  # #
#   ## #E#
##########
